 8 11 12 -1 -1 -1 12 11  8
10  8 11 12 -1 12 11  8 10
-1 10  8 11 12 11  8 10 -1
 6  2 10  8 11  8 10  2  6
 0  6  2 10  8 10  2  6  0 