2 2 2 2 2 2 2 2 2
2 2 4 2 2 2 4 2 2
2 2 2 2 2 2 2 2 2
2 6 6 6 6 6 6 6 2
2 2 2 2 2 2 2 2 2 