 4  5 13  7  8  9 10  4  5
 3  4 12 13  7  8  9  3  4
 9 10 11 12 13  7  8  9 10
 1  2 10 11 12 13  7  1  2
 0  1  9 10 11 12 13  0  1 
