10 11 11 11 10 11  7  7  7
10 11  8 11 10 12 11 11  7
10  8  8  8 10 11  7  7  7
10 11  8 11 10 12  7 11 11 
10 11 11 11 10 11  7  7  7